{
    "name": "Level 1",
    "grid": [
        "..........",
        "..........",
        "U.S....S.U",
        ".U.S..S.U.",
        "..U.SS.U..",
        "...U..U...",
        "....UU....",
        "..........",
        "..........",
        ".........."
    ]
}