{
    "name": "Level 1",
    "grid": [
        "SHSHSHSHSH",
        "HSHSHSHSHS",
        "..........",
        "..........",
        "..........",
        "..........",
        "..........",
        "..........",
        "..........",
        ".........."
    ]
}