{
    "name": "Level 1 - The beginning",
    "background": "0001",
    "isBossLevel": false,
    "isFinal": false,
    "grid": [
        "..............",
        "..............",
        "..............",
        "..............",
        "....GGGGGG....",
        "...GYYYYYYG...",
        "...GYYYYYYG...",
        "....GGGGGG....",
        "..............",
        "..............",
        "..............",
        "..............",
        "..............",
        ".............."
    ]
}