{
    "name": "Level 1",
    "grid": [
        "S..........S",
        "S..........S",
        "SU.S....S.US",
        "S.U.S..S.U.S",
        "S..U.SS.U..S",
        "S...U..U...S",
        "S....UU....S",
        "S..........S",
        "S..........S",
        "S..........S"
    ]
}